. Empty
@ Something
□ Start_Point

. . @ . . . . . □ . . . . . . . . . . . . . . . . . . . . . . . . @ . . .
. . . @ . . . . . . . . . . . . . . . . . . . . . . . . . . . . . . @ . .
. . @ . . . . . . . . . . . . . . . . . . . . . . . . . . . . . . @ . . .
. . . @ . . . . . . . . . . . . . . . . . . . . . . . . . . . . . . @ . .
@ . @ . . @ @ @ @ @ @ @ @ @ @ @ @ @ @ @ @ @ @ @ @ @ @ @ @ @ @ @ . @ . . @
@ . . @ . @ @ @ @ @ @ @ @ @ @ @ @ @ @ @ @ @ @ @ @ @ @ @ @ @ @ @ . . @ . @
@ @ @ @ @ @ @ @ @ @ @ @ @ @ @ @ @ @ @ @ @ @ @ @ @ @ @ @ @ @ @ @ @ @ @ @ @
. . @ @ . . . . . . . . . . . . . . . . . . . . . . . . . . . . . @ @ . .
. @ . . @ . . . . . . . . . . . . . . . . . . . . . . . . . . . @ . . @ .
@ . . . . @ @ @ @ @ @ @ @ @ @ @ @ @ @ @ @ @ @ @ @ @ @ @ @ @ @ @ . . . . @
