. Empty
@ Something
X Nowhere
□ Start_Point

. . @ . . . . . □ . . . . . . . . . . . . . . . . X X . . . . . . @ . . .
. . . @ . . . . . . . . . . . . . . . . . . . . . X X . . . . . . . @ . .
. . @ . . . . . . . . . . . . . . . . . . . . . . X X . . . . . . @ . . .
. . . @ . . . . . . . . . . . . . . . . . . . . . X X . . . . . . . @ . .
@ . @ . . @ @ @ @ @ @ @ @ @ @ @ @ @ @ @ @ @ @ @ @ @ @ @ @ @ @ @ . @ . . @
@ . . @ . @ @ @ @ @ @ @ @ @ @ @ @ @ @ @ @ @ @ @ @ @ @ @ @ @ @ @ . . @ . @
@ @ @ @ @ @ @ @ @ @ @ @ @ @ @ @ @ @ @ @ @ @ @ @ @ @ @ @ @ @ @ @ @ @ @ @ @
. . @ @ . . . . . . . . . . . . . . . . . . . . . . . . . . . . . @ @ . .
. @ . . @ . . . . . . . . . . . . . . . . . . . . . . . . . . . @ . . @ .
@ . . . . @ @ @ @ @ @ @ @ @ @ @ @ @ @ @ @ @ @ @ @ @ @ @ @ @ @ @ . . . . @
